{
    "groundTextureUrl": "./textures/ground.jpg",
    "wallTextureUrl": "./textures/wall.jpg",
    "doorTextureUrl": "./textures/door.jpg",
    "size": { "width": 12, "height": 12 },
    "map": [
        [3, 2, 2, 2, 3, 2, 2, 2, 3, 2, 2, 2, 1],
        [1, 0, 0, 0, 1, 0, 0, 0, 1, 0, 0, 0, 1],
        [1, 0, 5, 0, 1, 0, 5, 0, 1, 0, 5, 0, 1],
        [1, 0, 0, 0, 1, 0, 0, 0, 1, 0, 0, 0, 1],
        [1, 0, 0, 0, 1, 0, 0, 0, 1, 0, 0, 0, 1],
        [3, 4, 2, 2, 2, 4, 2, 2, 2, 4, 2, 2, 1],
        [1, 0, 0, 0, 0, 0, 0, 0, 0, 0, 0, 0, 1],
        [3, 4, 2, 2, 3, 4, 2, 2, 3, 4, 2, 2, 1],
        [1, 0, 0, 0, 1, 0, 0, 0, 1, 0, 0, 0, 1],
        [1, 0, 0, 0, 1, 0, 0, 0, 1, 0, 0, 0, 1],
        [1, 0, 5, 0, 1, 0, 5, 0, 1, 0, 5, 0, 1],
        [1, 0, 0, 0, 1, 0, 0, 0, 1, 0, 0, 0, 1],
        [2, 2, 2, 2, 2, 2, 2, 2, 2, 2, 2, 2, 0]
    ], 
    "initialPosition": [7, 6],
    "initialDirection": 0.0,
    "exitLocation": [-0.5, 6]
}
